1111111111111111111111111111111111111111111111111111111111111
1414441414444444444444444444444444441111144444441444444444441
1414141414111111111111111111111111144544441111141411111111141
1414141414111444444444444444444444111111111111141414444444441
1411141444111414111111111411411114111114111111141114111111111
1444441414444444144444441414414444111114144444444444444411111
1414111411111114141411111414414111111114141111111111111144441
1414411414444444441444444414414111111114141414444444441444441
1411411111414141411111111414144111111114141414111111141444441
1411444444444444444444444411141111111114144444144444141111441
1411111111111111111111111114441111111414141111141414144441441
1411114444414441444144444444111111111414141444441414111141441
1411114111414141414144111111111111111411141411111414444444441
1111114141414144414441111111111111111414141411111111111114441
1444444141414111111114344444444444444414444444444444444414441
1111111141414444444444111111111111111114141141141411141411111
1411111141411111111114244444444444444414141141141411141444441
1444444441444444444444244444444444444414141141141411141414111
1111111141111111111111111111111114111114141441141444441414111
1414444444444144444414444444444414144414141111141111111114441
1414111111114441111444111111111414141414141414141414141411141
1444111111111111111111114444414414111414141414141414141414141
1414444444144444444444414111414114444414444414144414444444441
1411111111141111111111114141414111111114111114111114111111111
1411444444144444444444444441414144444444144444444414444444441
1411111114111114111111111111414111111111141111111411111111141
1444444444444444144444444444414444444444444444441444444444441
1111111111111111111111111111111111111111111111111111111111111