1111111111111111111111111114444444444444444411111111111111111111111111111111111111111444444444444441
1111111111111111111111111114444444444444444411114444444444444444111111111444444444411444444444444441
1111111111111111111111111114444444444444444411114444444444444444111111111444444444411444444444444441
1111111111111111111111111444444444444444444411114444444444444444111111111444444444411444444444444441
1111111111111111114444444444444444444441111111114444444444444444111111111444444444411444444444444441
1111111111111111114444444444444444444441111444444444444444444444111111111444444444444444444444444441
1111111111111444444444444444444444444441111444444444444444444444111111111444444444444111111111111111
1111111111111444444444444444444444444441111444444444444444444444111444111444444444444111111111111111
1111111111111444444444444444444444444441111444444444444444444444111444111444444444444111111111111111
1111111111111444444444444444444444444441111444444441111111111111111444111444444444444111114444411111
1111111111111444444444444444444444444441111444444441111111111111111444111444444444444111114444411111
1111111111111444444444444444444444444441111444444441111111111111111444111444444444444111114444411111
4444111111111444444444444444444444444441111444444441111111111111111444111444444444444111111111111111
4444444111111444444444444444444444444441111444444441111111111111111444111444444444444111111111111111
4444444111111444444444444444444444444441111444444441111111111111111444111444444444444111111111111111
4444444444444444444444444444444444444441111444444441111111111111111444111444444444444111111111111111
4444444444444444444444444444444444444441111444444441111111111111111444111444444444444111111111111111
4444444444444444444444444444444444444441111444444441111111111111111444111444444444444111111111111111
4444444111111444444444444444444444444441111444444441111111111111111444111444444444444111111111111111
4444444144411444444444444444444444444441111444444441111111111111111444111144444444444444444444111111
4444444144444444444444444444444444444441111444444441144444444111111111111144444444444444444444111111
4444444144444444444444444444444444444441111444444441144444444111111111111144444444444444444444111111
4444444144444444441111144444444444444441111444444441144444444111111111144444444444444444444444111111
4444444144444444441111144444444441111111111444444441144444444111111111144444444444444444444444111111
4444444144444444441111144444444441111111111444444441144444444111111111444444444444444444444444111111
4444444144444444441111111111111111111444444441111111144444444111111111444444444444444444444444111111
4444444144444444441111111111111111111444444441111111144444444111111111444444444444444444444444111111
4444444144444444441111111111111111111444444441111111144444444111111111444444444444444444444444444111
4444444144444444441111111111111111111444444441114444144444444111111111444444444444444444444444444111
4444444144444444441111111111111111111444444441144444444444444111111111444444444444444444444444444111
4444444111444444441111111111111111111444444441144444444444444111111111444444444444444444444444444111
4444444111444444441111111111111111111444444444444444444444444111111111444444444444444444444444444111
4444444111444444441111111111111111111444444444444444444444444111111111444444444444444444444444444111
1111111111444444441111111111111111111444444444444444444444441111111111444444444444444444444444444111
1111111111444444441111111111111111111111114444444444444444441111111111444444444444444444444444444111
1111111111444444441111111111111111111111114444444444444444441111111111444444444444444444444444444111
1111111111444444441111111114444111111111114444444444444444441111111111111144444444444444444444444111
1111111111444444441111111114444111111111114444444444444444441111111111111144444444444444444444444441
1111144441444444441111111114444111111111111111144444444444441111111111111111114444444444444444444441
1111144441111111111111144444444444444411111111111111111111111111111111111111114444444444444444444441
1111144441111111111111144444444444444411111111111111111111111111111111111111111111111111111111144441
1111144441111111111111144444444444444411111111111111111111111111111111111111111111111111111111144441
1111144441111111111111144444444444444411111111111111111111111111111111111144444444444444111111144441
1111144441111111111111144444444444444411111111111111111111111111111111111144444444444444111111144441
1111144441111111111111144444444444444411111111111444444444444441111111111144444444444444111111144441
1111144444441111111111144444444444444411111111111444444444444441111111111144444444444444111111144441
1111144444441111111111144444444444444411111111111444444444444441111111111144444444444444111111144441
4444444444444444111111144444444444444411111111144444444444444441111111111144444444444444111111144441
4444444444444444111111144444444444444411111111144444444444444441111111111144444444444444111111111111
4444444444444444111111144444444444444411111111144444444444444441111111111144444444444444111111111111
4444444444444444111111144444444444444411111111144444444444444441111111111144444444444444444444111111
4444444444444444444411144444444444444411111111144444444444444441111111111144444444444444444444111111
4444444444444444444411144444444444444411111111144444444444444441111111111111111111111111444444111111
4444444444444444444411144444444444444411111111144444444444444411144444444411111111111111444444111111
4444444444444444444411144444444444444411111111144444444444444411144444444411111111111111444444111111
4444444444444444444411144444444444444444411111144444444444444411144444444411111111111111111111111111
1111111111444444444411111111111111444444411111144444444444444411144444444411111111111144411111111111
1111111111111111111111111111111111444444411111144444444444444411144444444411111111111144411111111111
1111111111111114444444444444411111444444411111144444444444444411144444444411111444441144411111111111
1111111111111114444444444444411111444444411111144444444444444411144444444411111444441144411111111111
1111111111111114444444444444411111444444411111144444444444444411144444444411111444441144411111111111
1111111111111114444444444444411111444444411111144444444444444411144444444411111444441144411111111111
1111111111111114444444444444411111444444411111144444444444444411144444444411111444441144411111111111
1111111111111114444444444444441111444444411111144444444444444411144444444411111444441144411111111111
1111111114441114444444444444441111444444411111144444444444444411144444444411111444441144411111111111
1111111114441114444444444444441111444444411111144444444444444411144444444411111444441144411111111111
1111111114441114444444444444441111444444411111144444444444444444444444444444441111111144411444441111
1111111114441114444444444444441111444444411111111111111111444444444444444444441111111144411444441111
1111111111111114444444444444441444444444411111111111111111444444444444444444441111111144411444441111
1111111111111114444444444444441444444444411111111111111111444444444444444444441111111144411444441111
1111111111111114444444444444441444444444411111111111111111444444444444444444441111111144411444441111
1111111111111114444444444444441444444444411111111111111111444444444444444444441111111111111444441111
1111111111111114444444444444441444444441111111111111111111444444444444444444441111111111111444441111
1444441111111114444444444444441444444441111111111111111111444444444444444444441111111111111444441111
1444441111111114444444444444441444444441111111111111111111444444444444444444441111111111111444441111
1444441111111114444444444444441444444444444444444444411111444444444444444444441111111111111444441111
1444441111111114444444444444441444444444444444444444411111444444444444444444441111111111111444441111
1111444444444444444444444444441444444444444444444444411111444444444444444444441111111111111444441111
1111444444444444444444444444441111111114444444444444411111444444444444444444441111111111111444441111
1111444444444444444444444444441111111114444444444444411111444444444444444444441111111111111444441111
1111444444444444444444444441111111111111111444444444111111111111111111111111111111111111111444441111
1111444444444444444444444441111111111111111444444444111111111111111111111111111111111111111444441111
1111444444444444444444444441111111111111111444444444111111111111111111444444111111111111111444441111
1111444444444444411111111111111111111111111444444444111111111111111111444444111111111111111444441111
1111444444444444411111111111111111111111111444444444111111111111111111444444111111111111111444441111
1111444444444444411111111111111111111111111444444444111111111111111111444444111111111111111111111111
1111444444444444411111111111111111111111111444444444111111111111111111444444111111111111111111111111
1111444444444444411111111111111111111111111444444444111111111111111111444444111111111111111111111111
1111444444444444411111111111111111111111111444444444111111111111111111444444111111111111111111111111
1111444444444444411111111111111111111111111444444444111111111111111111444444111111111111111111111111
1111444444444444411111111111111111111111111444444444111111111111111111444444111111111111111111111111
1111444444444444411111111111111111111111111444444444111111111111111111444444111111111111111111111111
1111111144444444444444441111111111111111111111111111111111111111111111444444111111111111111111111111
1111111144444444444444441111111111111111111111111111111111111111111111444444444111111111111111111111
1111111144444444444444441111111111111111111111111111111111111111111111444444444111111111111111111111
1111111144444444444444444111111111111111111111111111111111111111111111144444444111111111111111111111
1111111111111114444444444111111111111111111111111111111111111111111111144444444111111111111111111111
1111111111111114444444444111111111111111111111111111111111111111111111144444444111111111111111111111
1111111111111114444444444111111111111111111111111111111111111111111111111111111111111111111111111111
1111111111111111111111111111111111111111111111111111111111111111111111111111111111111111111111111111
